7
12
Xcсccccсcccc
cc####c####c
с##c##ccc#cc
c#ccc###cс#c
ccc#c#c##с#c
####c#c#сс#c
ccccccc#O#cc